
 _________________
|     |     |     |
|  1  |  2  |  3  |
|_____|_____|_____|
|     |     |     |
|  4  |  5  |  6  |
|_____|_____|_____|
|     |     |     |
|  7  |  8  |  9  |
|_____|_____|_____|


 _________________
|     |     |     |
|  0  |  1  |  2  |
|_____|_____|_____|
|     |     |     |
|  3  |  4  |  5  |
|_____|_____|_____|
|     |     |     |
|  6  |  7  |  8  |
|_____|_____|_____|
